10 11
|--------|
|-++++++-|
|-++--++-|
|-+++-++-|
|-+++-++-|
|-++++++-|
|-++-+++-|
|-++++++-|
|- +--++-|
|--------|